7777777777777777
7777777777777777
7777777777777777
7777771117777777
7777771317777777
7777771011117777
7777111202317777
7777130241117777
7777111121777777
7777777131777777
7777777111777777
7777777777777777
7777777777777777
7777777777777777
