7777777777777777
7777777777777777
7777777777777777
7777771111177777
7777111004177777
7777100230117777
7777100323017777
7777111052017777
7777771000117777
7777771111177777
7777777777777777
7777777777777777
7777777777777777
7777777777777777
