7777777777777777
7777777777777777
7777777777777777
7777711111117777
7777713323317777
7777713313317777
7777710222017777
7777710020017777
7777710222017777
7777710014017777
7777711111117777
7777777777777777
7777777777777777
7777777777777777
