7777777777777777
7777777777777777
7771111111177777
7771000000177777
7771012200177777
7771033310177777
7771133320117777
7777101102017777
7777120020017777
7777100100417777
7777111111117777
7777777777777777
7777777777777777
7777777777777777
