7777777777777777
7777777777777777
7777777711111177
7777111113000177
7777100133110177
7777100233000177
7777100103101177
7771110112100177
7771020000220177
7771012100100177
7771400111111177
7771111177777777
7777777777777777
7777777777777777
