7777777777777777
7777777777777777
7777777777777777
7777771111117777
7777771000017777
7777111222017777
7777140233017777
7777102333117777
7777111100177777
7777777111177777
7777777777777777
7777777777777777
7777777777777777
7777777777777777
