7777777777777777
7777777777777777
7777777777777777
7777777777777777
7771111771111177
7711001771000177
7710201111200177
7710023333020177
7711000010401177
7771111111111777
7777777777777777
7777777777777777
7777777777777777
7777777777777777
