7777777777777777
7777777777777777
7777777777777777
7777111111117777
7777100100017777
7777102332017777
7777142350117777
7777102332017777
7777100100017777
7777111111117777
7777777777777777
7777777777777777
7777777777777777
7777777777777777
