7777777777777777
7777777777777777
7777111111777777
7777100001117777
7777102000017777
7711102011017777
7713330200017777
7713332120117777
7711110102017777
7777710040017777
7777711111117777
7777777777777777
7777777777777777
7777777777777777
