7777777777777777
7777777777777777
7111111777111117
7100001117100317
7100202017133317
7101002011100317
7100222000204317
7111002002100317
7771002120133317
7771100000100317
7777111111111117
7777777777777777
7777777777777777
7777777777777777
