7777777777777777
7711111111177777
7710001100111177
7710200000000177
7711211101100177
7710011050101177
7710233333301777
7110111030101777
7100000211121777
7100010000241777
7111112101111777
7777710001777777
7777711111777777
7777777777777777
