7777777777777777
7777777777777777
7777711117777777
7777714011177777
7777710200177777
7777111010117777
7777131010017777
7777132001017777
7777130002017777
7777111111117777
7777777777777777
7777777777777777
7777777777777777
7777777777777777
