7777777777777777
7777777771111177
7777777710000017
7777777100211001
7777771001000201
1771771010010101
7171771020200201
7711111110121001
7710020200000017
7714332055311177
7771333333111117
7777111111111111
7777777777777777
7777777777777777
