7777777777777777
7777777777777777
7777111117777777
7777140017111777
7777102217131777
7777102011131777
7777111000031777
7777711000001777
7777710001001777
7777710001111777
7777711111777777
7777777777777777
7777777777777777
7777777777777777
