7777777777777777
7777771111111117
7777771000000017
7777771010101017
7777771002021017
1111111000200017
1331001102021017
1330001102020017
1331001101111117
1331010202017777
1330000020017777
1001110401117777
1111711111777777
7777777777777777
