7777777777777777
7777777777777777
7777777777777777
7777777777777777
7777111111117777
7777133333317777
7777100201011777
7777102010201777
7777112020201777
7777710040001777
7777711111111777
7777777777777777
7777777777777777
7777777777777777
