7777777777777777
7777777777777777
7777777777777777
7777111111177777
7777100000111777
7771121110001777
7771040200201777
7771033102011777
7771133100017777
7777111111117777
7777777777777777
7777777777777777
7777777777777777
7777777777777777
