7777777777777777
7777777777777777
7777777777777777
7777777777777777
7777111111111177
7711100030000177
7710001121100177
7710423030321177
7711021121101777
7771000030001777
7771111111111777
7777777777777777
7777777777777777
7777777777777777
