7777777777777777
7777777777777777
7777777777777777
7777771111117777
7771111000417777
7771002220017777
7771011011017777
7771000200017777
7771002010117777
7771111000177777
7777771111177777
7777777777777777
7777777777777777
7777777777777777
