7777777777777777
7777777777777777
7777777777777777
7777777111111777
7777111130041777
7777100222001777
7777131131131777
7777100020001777
7777100231011777
7777111100017777
7777777111117777
7777777777777777
7777777777777777
7777777777777777
