7777777777777777
7777777777777777
7777777777777777
7777711111177777
7777710000177777
7777710020177777
7777111002117777
7777102002017777
7777101211017777
7777100040017777
7777111111117777
7777777777777777
7777777777777777
7777777777777777
