7777777777777777
7777777777777777
7777777777777777
7777111111777777
7777130331777777
7777130231777777
7771110021177777
7771020020177777
7771012110177777
7771000400177777
7771111111177777
7777777777777777
7777777777777777
7777777777777777
