7777777777777777
7777711111177777
7771110000111777
7771000120001117
7771000200022017
7771022012000017
7771100020002017
7111111012111117
7100401200177777
7101000021177777
7100002101777777
7100000001777777
7111111111777777
7777777777777777
