7777777777777777
7777711111177777
7771110000111777
7771000120001117
7771000200022017
7771022012000017
7771100020002017
7111111012111117
7133401200177777
7131330021177777
7133332101777777
7133330001777777
7111111111777777
7777777777777777
