1111111111111117
1000000100000017
1020120102112017
1010020100000017
1000112121122017
1010103330100017
1020030103201017
1021423331010017
1000030103002017
1011321112301017
1010233333011017
1000000000000017
1111111111111117
7777777777777777
