7777777777777777
7777777777777777
7771111111117777
7771000110017777
7771010202017777
7771005310017777
7771101343117777
7771121115111777
7771000000001777
7771000110101777
7771111110001777
7777777711111777
7777777777777777
7777777777777777
