7777777777777777
1111111177777777
1000000177777777
1022000111777777
1002022201111177
1101103330000117
7101413331112017
7101023330000017
1101023332010117
1001111101110177
1000000200020177
1111111111100177
7777777777111177
7777777777777777
