7777777777777777
7777777777777777
7777777777777777
7777771111177777
7777771040177777
7777771222177777
7771111000177777
7771000312117777
7771023230317777
7771001313117777
7771111111177777
7777777777777777
7777777777777777
7777777777777777
