7777777777777777
7711111111111177
7713330100000177
7713300101100177
7713300000100177
7713300102110177
7713330120200177
7711111100220177
7771100202200177
7771402220010177
7771102011000177
7777100000000177
7777111111111177
7777777777777777
