7777777777777777
7777777777777777
7771111111117777
7771000000017777
7771002020217777
7771101211017777
7777103303311777
7777113303301777
7777710112101177
7777712020200177
7777710000004177
7777711111111177
7777777777777777
7777777777777777
