1111177777711117
1400111111110017
1102000000020017
7101010011110017
7100200011112117
7120110102020177
1102002100000177
1000100000010177
1000111112111177
1111100010001777
7777133300201777
7777133331001777
7777133331111777
7777111111777777
