7777777777777777
7777777777777777
7777777777777777
7777777711111777
7777111110001777
7777103302101777
7777101350001777
7771105312011777
7771020020017777
7771000110417777
7771111111117777
7777777777777777
7777777777777777
7777777777777777
