7777777777777777
7777777777777777
7711111711111117
7710001110010017
7710200000204017
7711012113110017
7771003335302017
7771021013101017
7771100002000017
7777100111111117
7777111177777777
7777777777777777
7777777777777777
7777777777777777
