7777777771117777
7777111111411777
7777133331201177
7777133331020177
7777133330200177
7777103331000177
1111110111110117
1020200020010017
1000022000202017
1110202020011117
7711000202017777
7771001111117777
7771111777777777
7777777777777777
