7777777777777777
7777777777777777
7777711111777777
7771110001117777
7711004202017777
7710011011011777
7710231320001777
7710131510001777
7710233300111777
7711121011177777
7777100017777777
7777111117777777
7777777777777777
7777777777777777
