7777777777777777
7777771111777777
7777771001111117
7777771000010017
7777771022000017
1111111210010017
1001303301112117
1001315320000017
1001313510100017
1022333310111117
1042010110177777
1022210000177777
1000011111177777
1111117777777777
