1111777777777777
1001117777777777
1020011177777777
1020200111777777
1020202001117777
1020202000017777
1020200100011777
1020011022201777
1401111000001177
1101013222223177
7101113333333117
7100035555555317
7111133333333317
7777111111111117
