7777777777777777
7777777777777777
7711111117777777
7710410011111777
7710220020001777
7710013112101777
7711213330001777
7711033311211777
7710011311001777
7710020020001777
7710010001001777
7711111111111777
7777777777777777
7777777777777777
