7777777777777777
7777777777777777
7777711111777777
7777710401777777
7777710201777777
7777712321777777
7771113231177777
7711032323111777
7710023232001777
7710000300001777
7711111111111777
7777777777777777
7777777777777777
7777777777777777
