7777777777777177
7777777777771177
7777777777711177
7777777777100017
7771111111101017
7710202020200017
7110131313142177
1113333333000117
7110101010121177
7710202020200017
7771111111101017
7777777777100017
7777777777711177
7777777777771177
