7777777777777777
7777777777777777
7777777777777777
7771111111777777
7771003201117777
7771032320017777
7771523234017777
7771032320117777
7771003200177777
7771111111177777
7777777777777777
7777777777777777
7777777777777777
7777777777777777
