7777777777777777
7777777777777777
7777777771111177
7777777771000177
1111111111050111
1000000000030001
1022225555233341
1000000000030001
1111111111050111
7777777771000177
7777777771111177
7777777777777777
7777777777777777
7777777777777777
