7777777777777777
7777777777777777
7777777111177777
7711111100111117
7714200002002017
7712111020101017
7710010010200017
7710210000101117
7710020121000177
7713333333330177
7711111111000177
7777777771111177
7777777777777777
7777777777777777
