7777777711117777
7711111110011117
7710000200333317
1110001010331317
1022010010333317
1000010210331317
1121112001110017
7100100202000017
7100002020012017
7102110201100117
7110111101041177
7710001002011777
7711100000117777
7777111111177777
