7777777777777777
7777777777777777
7711111111111777
7710000100001777
7710242222201777
7710000000001777
7711111011111777
7777713001777777
7777713001777777
7777713331777777
7777713001777777
7777711111777777
7777777777777777
7777777777777777
