7777777777777777
7777711111777777
7777710401777777
7777710201777777
7771110301117777
7771000500017777
7771055555017777
7771000500017777
7771112521117777
7777710301777777
7777710501777777
7777710301777777
7777711111777777
7777777777777777
