7777777777777777
7111111111111117
7130000000000017
7132020202020017
7131111111110017
7131350203325117
7131020205324177
7131300203322177
7131111111113177
7130000000000177
7131212121212177
7130000000000177
7111111111111177
7777777777777777
