7777777777777777
7777777777777777
7111111111111777
7133001000001117
7133001020020017
7133001211110017
7133000040110017
7133001010020117
7111111011202017
7771020020202017
7771000010000017
7771111111111117
7777777777777777
7777777777777777
