7777777711117777
7111111110011117
7100011333330017
7100200113331017
7110020011101017
7710102001000017
7710010200100017
7710001020010017
7710000102010117
7711110010200177
7777711001020177
7777771141000177
7777777111111177
7777777777777777
