7777777777777777
7777711111117777
7711110000017777
7710003111017777
7710101000011777
7710102021301777
7710100500101777
7710312020101777
7711000010101117
7771011130000417
7771000001100017
7771111111111117
7777777777777777
7777777777777777
