7777777777777777
7777777777777777
7111177777711117
7133111111113317
7153533333535317
7102020202020217
7120202420202017
7102020202020217
7120202020202017
7135353333353517
7133111111113317
7111177777711117
7777777777777777
7777777777777777
