7777777777777777
7777777777777777
7777771111177777
7777711000111177
7777710335020177
7711110131000177
7710000353141177
7710121121101777
7710000020201777
7711001000111777
7771111111177777
7777777777777777
7777777777777777
7777777777777777
