7777777777777777
7777777777777777
7777777777777777
7771111117777777
7771000017777777
7771020011117777
7771025335017777
7771053352017777
7771111002017777
7777771040017777
7777771111117777
7777777777777777
7777777777777777
7777777777777777
