7777777777777777
7777777777777777
7777777777777777
7777771111177777
7771111300117777
7771023230017777
7771421012017777
7771023030017777
7771111212017777
7777713030017777
7777711111117777
7777777777777777
7777777777777777
7777777777777777
