7777777777777777
7777777777777777
7777777777777777
7777777777777777
7711111111111177
7710000333020177
7710222555024177
7710000333020177
7711111111111177
7777777777777777
7777777777777777
7777777777777777
7777777777777777
7777777777777777
