7777777777777777
7777777777777777
7777777777777777
7777777777777777
7771111111111777
7771100000001777
7771000121201777
7771022003231777
7771041113331777
7771111111111777
7777777777777777
7777777777777777
7777777777777777
7777777777777777
