7777777777777777
7777777777777777
7777111177777777
7777100111117777
7771120110017777
7771002420017777
7771000112017777
7771113110111777
7777133320201777
7777113300001777
7777711111111777
7777777777777777
7777777777777777
7777777777777777
