1111171111777777
1333171001111777
1333111002001777
1333311020021117
1133331100020017
1113330110202017
1011000010020017
1001101011101111
1020101200200001
1002040200002001
1000102022020111
1001111110011177
1011777711117777
1117777777777777
