7777777777777777
7777777777777777
7777777777777777
7777111111177777
7777130303177777
7777102220177777
7777132423177777
7777102220177777
7777130303177777
7777111111177777
7777777777777777
7777777777777777
7777777777777777
7777777777777777
