7777777777777777
7777777711117777
7711111110017777
7710000020017777
7710002114217777
7711213331017777
7771023330017777
7771013031011777
7771000101201777
7771200200001777
7771001111111777
7771111777777777
7777777777777777
7777777777777777
