7777777777777777
7777777777777777
7777777777777777
7777777777777777
7777711111117777
7777110010417777
7777100010017777
7777120202017777
7777102110017777
7711102010117777
7713333300177777
7711111111177777
7777777777777777
7777777777777777
