7777777777777777
7777777777777777
7777711111111177
7777710001000177
7777710000000177
7711111511101177
7710003330001777
7710101511121177
7710200002000177
7711111401000177
7777771111111177
7777777777777777
7777777777777777
7777777777777777
