1111177777777777
1333171111177777
1333111000177777
1333300022111117
1333300100100011
1331211110121001
1102001000002201
1002104020221001
1020202010002011
1000100201100017
1111110001111117
7777711111777777
7777777777777777
7777777777777777
