7777777777777777
1111111111111117
1113100000011117
1133102002010017
1333101102010017
1333330012200017
1133332000012017
1111011111110017
1000200000000117
1002010021020117
1021110201022017
1000410011000017
1111111111111117
7777777777777777
