7777777777777777
7777777111111117
7777777100100017
7111111102233317
7100000000133317
7101111112133317
1101000000133317
1001012020111117
1010202020177777
1040020100177777
1111120220177777
7777100000177777
7777111111177777
7777777777777777
