7777777777777777
7777777771111177
7777111111000177
7711100003020177
7710200123121177
7710010043100177
7711011113000177
7771020015111177
7771011013001777
7771000003101777
7771112000001777
7777710011111777
7777711117777777
7777777777777777
