7777777777777777
7777777777777777
7777771111777777
7711111001111177
7710000200020177
7710021211000177
7711101353011177
7777103330417777
7777110121117777
7777710001777777
7777711111777777
7777777777777777
7777777777777777
7777777777777777
