7777777777777777
7777777777777777
7777777777777777
7777771111111177
7771111000030177
7771002020230177
7771003111131177
7771023202041777
7771003001111777
7771111111777777
7777777777777777
7777777777777777
7777777777777777
7777777777777777
