7777777777777777
7777777777777777
7777111117777777
7777100017777777
7711123211111777
7710003020001777
7710112110401777
7710003011111777
7711103017777777
7777100017777777
7777111117777777
7777777777777777
7777777777777777
7777777777777777
