7777777777777777
7777777777777777
7777111117777777
7777104011111177
7777101335000177
7777103331000177
7771121102020177
7771000121111177
7771000200017777
7771111101017777
7777777100017777
7777777111117777
7777777777777777
7777777777777777
