7777771111117777
7777111000011777
7777100011001777
7711121100101777
7110000033101777
7100212153101777
7102240135101117
7100220133100017
7110000133200017
7711121130101117
7777100111001777
7777110000011777
7777711111117777
7777777777777777
