7777777777777777
7777777777777777
7777771111117777
7777111000017777
7771130211011777
7771332020041777
7771330202011777
7771111110017777
7777777711117777
7777777777777777
7777777777777777
7777777777777777
7777777777777777
7777777777777777
