7777777777777777
7777771111111777
7777771001001777
7777771002201777
7111111021001777
7133311101001177
7130010020100177
7130000202020177
7130010020100177
7133311101001177
7111111020001777
7777771401001777
7777771111111777
7777777777777777
