7777777777111111
7777777777100001
1111177711101101
1330111110200101
1330000020002101
1330011011000101
1330110201202101
1330100000200101
1330100201112001
1330102020020111
1110110102000017
7710000141102017
7711111111100117
7777777777111177
