7777777777777777
7777777777777777
7777777717777777
7777771111177777
7777111040111777
7777100202001777
7777105353501777
7777103202301777
7777105353501777
7771100202001177
7711111111001117
7111111111111111
7777711777117777
7777777777777777
