7111111111111117
7104050505010011
7121005050010001
7101050505000001
7101005050011011
7101050505011017
7101005050011017
7101050505011017
7101005050011017
7101050305011011
1101111111111001
1000000000000001
1000111111111001
1111177777771111
