7777777777777777
7777777777777777
7711111111111117
7710000100110017
7712220102200211
7710200100333301
7710020012311301
7710010210333311
7112020012311301
7102002042333301
7100011100111111
7111117111177777
7777777777777777
7777777777777777
