7777771111111117
7777771000000017
7777771002121017
7711111100102017
7710001020020017
7110200000111017
7100012111100017
7100002011101117
7111113304101177
7777133320220177
7777133310000177
7777133311111177
7777111117777777
7777777777777777
