1111777771111777
1001111111331117
1020202001333317
1020002201555317
1020202001335317
1002020201535317
1102020203535311
1002020203535341
1002020201535311
1020202001335317
1020002201555317
1020202001333317
1001111111331117
1111777771111777
