7777771111177777
1111111000177777
1000113000177777
1002133001117777
1100333122011111
7102313200000001
7102111211010201
7100010000022101
7112210112120001
7133302402000111
7133312100011177
7133300111117777
7111111177777777
7777777777777777
