7777777777777777
7771111771111117
7771001111000017
7711500050550017
7710205000051017
7710300011100017
7711111100014117
7710503050055017
7710001000100017
7711500050121017
7771001111100017
7771111777111117
7777777777777777
7777777777777777
