7777777777777777
7777777777777777
7777777777777777
7777111111111777
7777100010001777
7777102222201777
7771102020201777
7771020040001777
7771020111101177
7771001333330177
7771100333330177
7777111111111177
7777777777777777
7777777777777777
