7777777777777777
7771111111777777
7771000001777777
7771020201177777
7771111133111117
1111113353002017
1002423333122017
1000201211100017
1111100000001117
7777111001111777
7777771001777777
7777771111777777
7777777777777777
7777777777777777
