7777777777777777
7777777777777777
7777777777777777
7777777777777777
7771111177777777
7771000111111777
7771020330201777
7771120332241777
7777100330201777
7777111111111777
7777777777777777
7777777777777777
7777777777777777
7777777777777777
