7777777777777777
7777777777777777
7777777777777777
7777111117777777
7777100011111177
7711121300000177
7710203331020177
7714023152000177
7711110000111177
7777711111177777
7777777777777777
7777777777777777
7777777777777777
7777777777777777
