7777777777777777
7777111117777777
1111100017777777
1000204017777777
1002013111117777
1120113110011117
7100333330210017
7102113110012017
7100013110000017
7111020111110117
7771012000002017
7771000011100017
7771111117111117
7777777777777777
