7777777777777777
7777777777777777
7777111111177777
7777100500177777
7777104320177777
7777102300177777
7777153555177777
7777100500177777
7777102520177777
7777100300177777
7777111111177777
7777777777777777
7777777777777777
7777777777777777
