7711111111177777
7710000100177777
1110120020111177
1002001133100111
1010020133202001
1022002133001001
1100100333120001
7120401333102001
7100001333200011
7101120111000117
7100020000011177
7100111111117777
7111177777777777
7777777777777777
