7777111111111177
7111133333300177
7100033333100177
7100133333301177
7110111121121777
7142002020001117
7102200001100017
7101002211001017
7100020010220017
7100200200012017
7111100010202017
7777100010000017
7777111111111117
7777777777777777
