7777771111111117
7777771000000017
7777771202220017
7777771000102017
7777771000242017
7777111202010117
7777100021210177
1111101001000177
1333001021011177
1333330001017777
1333331021017777
1111111100017777
7777777111117777
7777777777777777
