7777777777777777
7711111711111177
7710001110000177
7110202012012177
7100204020020117
7101001101333317
7100110201311317
7110020000333317
7710220121333317
7710001000120117
7711111020000177
7777771111001177
7777777771111777
7777777777777777
