1111777777777777
1001777777777777
1001111111111777
1000011000001777
1331000022101777
1330011000201117
1331001121020017
1330001042020017
1331001020200017
1030001020201117
1001001000111777
1001000011177777
1111111117777777
7777777777777777
