7777777777777777
7777777777777777
7777777777777777
7777777777777777
7777777777777777
7777711111177777
7777710203177777
7777714023177777
7777711111177777
7777777777777777
7777777777777777
7777777777777777
7777777777777777
7777777777777777
