7777777777777777
7777777777777777
7777777777777777
7777771111777777
7777771331777777
7777711031177777
7777710023177777
7777110200117777
7777100122017777
7777100400017777
7777111111117777
7777777777777777
7777777777777777
7777777777777777
