7777777777777777
7777777777777777
7777111111177777
7777133330177777
7771113332111777
7771002120201777
7771022001201777
7771000010001777
7771111040111777
7777771111177777
7777777777777777
7777777777777777
7777777777777777
7777777777777777
