7777777777777777
7777777777777777
7777777777777777
7777771111117777
7777111000011117
7777100020020017
7777102000020417
7777111221111117
7777771003317777
7777771333317777
7777771111117777
7777777777777777
7777777777777777
7777777777777777
