7777777777777777
7777777777777777
7777111111111777
7777100110001777
7777100020001777
7777120111021777
7777101333101777
7771101333101177
7771020020020177
7771000001040177
7771111111111177
7777777777777777
7777777777777777
7777777777777777
