7777777777777777
7777777777777777
7777771111117777
7777771033317777
7771111333317777
7771001112011177
7771020200220177
7771402020000177
7771000111000177
7771111171111177
7777777777777777
7777777777777777
7777777777777777
7777777777777777
