7777777777777777
7777777777777777
7777777777777777
7777777777777777
7777711111177777
7777110000117777
7777102022017777
7777133333317777
7777102202017777
7777111041117777
7777771111777777
7777777777777777
7777777777777777
7777777777777777
