7777777777777777
7777777777777777
7777777777777777
7771111117777777
7771000017777777
7771022211777777
7771001331117777
7771100332017777
7777104000017777
7777111111117777
7777777777777777
7777777777777777
7777777777777777
7777777777777777
