7777777777777777
7777777777777777
7777711111111777
7777710001301777
7777110023331777
7777100201531777
7771101121011777
7771000200201777
7771000100001777
7771111111401777
7777777771111777
7777777777777777
7777777777777777
7777777777777777
