7777111177777777
1111100177777777
1002020171111111
1000200171535351
1102020111353531
7120200100535351
7142020000353511
7120200100535351
1102020111353531
1000200171535351
1002020171111111
1111100177777777
7777111177777777
7777777777777777
