7777777777777777
7777777777777777
7777771111777777
7777711001777777
7777714201777777
7777711201177777
7777711020177777
7777713200177777
7777713353177777
7777711111177777
7777777777777777
7777777777777777
7777777777777777
7777777777777777
